R 1920 1080

NO	 ./textures/spooky_walln.xpm
SO ./textures/spooky_walls.xpm
WE ./textures/spooky_wallw.xpm
EA ./textures/spooky_walle.xpm

S ./textures/spooky.xpm
F 59,64,58
C 62,78,105


		1111111111111111111111111
		1000000002110000000000001
		1011001001110000002000001
		1001000000000000000002001
 11111111011002001110000000000001
120000000011000001110111110111111
11110111111111011100000010001
11110111120111011101000011001
11000000110101011100000010001
10002000000000001100001010101
10000000010000001101010010001
11000001111101011111011110011111
11110111 1110001 120000210000001
1000011111111101 111111111111101
1011100000001101			1111
10110000100011011111111111
100000000000000000000000211
100010020W0010000020000111111
1000000001200000000000000021
1111111111111111111111111111