R 1920 10800

NO	 ./textures/trip_n.xpm
SO ./textures/trip_s.xpm
WE ./textures/trip_w.xpm
EA ./textures/trip_e.xpm

S ./textures/missingno.xpm
F   15,69,73
C 50,38,50

 1111111111111111111111
10000001000000000020001
10020000001000010100011
111111000000001 1000001
11000000002000011001021
1000120000E000000001001
10010001000001000010001
10101111110000100210001
10000000000020001110021
11111111111111111111111