R 1920 1080

NO	 ./textures/trip_n.xpm
SO ./textures/trip_s.xpm
WE ./textures/trip_w.xpm
EA ./textures/trip_e.xpm

S ./textures/missingno.xpm
F 77,92,53
C 163,208,230

11111111111111111111111
10000200000000000020001
10020000000000000000001
10100010000000011000201
10000000002000000002001
1000120000E000000001001
10000000000001000000001
10001100000000000200001
10000000000020001000001
11111111111111111111111