R 1920 1080

NO	 ./textures/north_texture.xpm
SO ./textures/south_texture.xpm
WE ./textures/west_texture.xpm
EA ./textures/east_texture.xpm

S ./textures/sprite.xpm
F 77,92,53
C 163,208,230


		1111111111111111111111111
		1000000002110000000000001
		1011001001110000002000001
		1001000000000000000002001
 11111111011002001110000000000001
120000000011000001110111110111111
11110111111111011100000010001
11110111120111011101000011001
11000000110101011100000010001
10002000000000001100001010101
10000000010000001101010010001
11000001111101011111011110011111
11110111 1110001 120000210000001
10000111 1111101 1111111111111N1
10111   	 101			1111
1011111111111101111111111
100000000000000000000000211
1000100200001111111110111111
1000000001000000000000000021
1111111111111111111111111111