R 1920 1080

NO	 ./textures/north_texture.xpm
SO ./textures/south_texture.xpm
WE ./textures/west_texture.xpm
EA ./textures/east_texture.xpm

S ./textures/sprite.xpm
F 77,92,53
C 163,208,230

11111111111111111111111
10000200000000000000001
10000000000000000000001
10000000000000000000001
10000000002000000000001
1000000000N000000000001
10000000000000000000001
10000000000000000000001
10000000000000000000001
11111111111111111111111